1 //level
20 //top time
1-15-15 //floor-height-width
2-15-15
::
1----------------
-WWIIIIWIIIWIWWW-
-WIIIIIIWIIIWIII-
-IIIIIIIWIIIWIII-
-IIIIIIIWIIIIIII}
-WIIIWWIIIIIWIII-
-IIIWIIIIIIIIIII-
-IIIIIIIWIIIIIII-
-IIIIIIIIIIIWIII-
-IIIWWIIIIIIWIII-
-IIIIIIIIIIIWIII-
-IIIIIIIWIIIIIIW-
-WIIIIIIIIWIIIIW-
-WWIIIIIIIIIIIWW-
-WWIIIIIWIIIIIWW-
-WWWWIIWWIIIWWWW-
----------{------